#############################################
#.............#.............................#
#.............#..................############
#.............#........................#....#
#.............#######.........#........#....#
#.............................#........#....#
########..S............########........#....#
#......#...................S..#.............#
#......#######................#...###########
#......#......................#......#......#
#.........................############......#
#...........................................#
#############################################