....................................................
..........#.....................#...................
...........#...................#....................
............#.................#.....................
.............#...............#......................
....####......#.............#.......####............
....................................................
...#....###########################.....#...........
...#..........#.............#...........#.......#...
...#....#########.........#########.....#.......#...
...#................S.S.................#.....#####.
...#....................................#.......#...
...#....................................#.......#...
...#....................................#...........
...#....................................#...........
....................................................
....##...##...##...##...#.....#......###..#...#.....
....#.#.#.#..#..#..#.#..#....#.#....#.....#...#.....
....#..#..#..#..#..#..#.#...#####....#....#####.....
....#.....#...##...#...##..#.....#..###...#...#.....
....................................................
