............................................
..........#.....................#...........
...........#...................#............
............#.................#.............
.............#...............#..............
....####......#.............#.......####....
............................................
...#....###########################.....#...
...#..........#.............#...........#...
...#....#########.........#########.....#...
...#................S.S.................#...
...#....................................#...
...#....................................#...
...#....................................#...
...#....................................#...
............................................
........##...##...##...##...#.....#.........
........#.#.#.#..#..#..#.#..#....#.#........
........#..#..#..#..#..#..#.#...#####.......
........#.....#...##...#...##..#.....#......
............................................
