#####################
#............#......#
#............#......#
#######......#......#
#.....#.............#
#.....#...S...#######
#.....#.............#
#.....#.............#
#.....########......#
#.....#.............#
#.....#.............#
#...................#
#...................#
#....######.#########
#......#............#
#......#............#
#......#..S.........#
#......#............#
#...................#
#..##....######.....#
#........#..........#
#####################